2 13 31
###############################
#p   *2    1  *  ** * *  1   *#
# #b# # #*# # #*# # # # # #*# #
#* 1x* * *** **   1  *    ** 1#
# #*# # # # # # #f# # # # # #*#
#  1    2  *  2  **      *  **#
# # #*# # # # # #*#*#*#*# # # #
#  2*  s 3   *   * *x* *      #
# # # # #*#*#*#*# # #*#*# #*# #
#   ****   4  1  *  3  *      #
# # # # # # # # # #*# # # # #*#
#  ** * 1 *    1    2    1    #
###############################