3 13 31
###############################
#p    * **  1 *    3  1 4  2  #
# #*# #*# # #*# # # #*# # #*# #
#*     ** * *  * 1 * **   *   #
# #*#*#*# #*# # #f# # # #*# # #
#* 1 *s*  1 *** * x ** 1   2  #
# # #*# # #*# #*#*# # # #*#*# #
# 1  *  2  * 2 3 b  * 2  **   #
# #*# # #*#*#*#*# # # # # #*# #
#  4  1  * 1 * * 2  *   *  3  #
#*# # #x#*# #*# # #*# #*# # #*#
# * 1  * **  1 ** ***  3 4    #
###############################